################
#..............#
#.####.##.####.#
#..............#
#.##.######.##.#
#..............#
#.####.##.####.#
#......P ......#
#.##.######.##.#
#..............#
#.####.##.####.#
################
